10 10
1111001111
0101001001
0100011001
0101110111
1110010001
0011011100
0010010101
1111110111
1001000001
1011111101